#######
#.TC.##
#.C#..#
#.C@T.#
#T...##
#######